11111111111111111111
100CC000000001000011
10000000110000000101
10000000110000000101
100000000000E0000C01
10000000000P00000001
100CCCC0000000000C01
1000000000C000000C01
10000C0000P000000001
10CCC000110000000001
10000000010010000001
11111111111111111111